1  1  2  5  -4  2  1  4  7
8 9 4 9 7 3 4 7 9
1 6 -4 2 9 7 8 9 0
8 9 6 5 8 9 0 7 3
3 5 7 4 2 6 -7 8 3
4 6 7 2 5 7 8 4 2
4 6 -7 2 8 6 9 3 1
0 9 6 4 2 3 1 5 6
1 5 7 9 6 3 5 6 8